9 100
255 1750 3
2 2 2 2 5 2 2 2 2
2 0 0 0 6 0 0 0 2
2 0 0 0 0 0 0 0 2
2 0 0 0 0 0 0 0 2
2 0 0 0 0 0 0 0 2
2 0 0 0 0 0 0 0 2
2 0 0 0 0 0 0 0 2
2 0 0 0 0 0 0 0 2
2 0 0 0 0 0 0 0 2
2 0 0 0 0 0 0 0 2
2 9 9 9 9 9 9 9 2
2 0 0 0 0 0 0 0 2
2 0 4 0 4 0 4 0 2
2 0 0 0 8 0 0 0 2
2 0 0 8 7 8 0 0 2
2 0 0 4 8 4 0 0 2
2 7 7 0 0 0 7 7 2
2 7 7 0 0 0 7 7 2
2 0 0 0 8 0 0 0 2
2 7 4 8 8 8 4 7 2
2 0 0 0 7 0 0 0 2
2 4 0 8 8 8 0 4 2
2 0 7 0 8 0 7 0 2
2 0 0 0 0 0 0 0 2
2 8 8 8 0 8 8 8 2
2 0 0 0 0 0 0 0 2
2 0 0 0 0 8 8 8 2
2 0 7 0 0 8 8 8 2
2 0 0 0 0 0 0 0 2
2 8 8 8 0 4 0 0 2
2 8 8 8 0 0 7 0 2
2 0 0 0 0 0 0 0 2
2 0 0 4 0 0 4 0 2
2 0 0 0 8 8 8 0 2
2 0 7 4 8 8 8 0 2
2 0 0 0 0 0 0 0 2
2 0 0 0 0 0 0 0 2
2 0 0 4 0 0 4 0 2
2 8 8 8 0 0 0 0 2
2 8 8 8 0 0 7 0 2
2 0 0 0 0 0 0 0 2
2 0 7 0 0 8 8 8 2
2 0 0 0 0 8 8 8 2
2 0 0 0 0 0 0 0 2
2 0 0 4 0 0 4 0 2
2 0 0 0 0 0 0 0 2
2 7 0 0 0 0 8 8 2
2 7 7 0 0 8 8 8 2
2 7 7 0 0 8 8 8 2
2 7 0 0 0 0 8 8 2
2 0 0 0 0 0 0 4 2
2 0 4 7 7 8 0 0 2
2 0 7 7 8 8 0 0 2
2 7 7 8 8 0 0 0 2
2 7 8 8 0 0 0 7 2
2 0 4 0 0 0 7 8 2
2 7 0 0 0 7 8 8 2
2 8 7 0 0 0 7 8 2
2 8 8 7 0 0 0 7 2
2 8 7 0 0 4 0 4 2
2 7 0 0 0 0 0 7 2
2 0 0 0 0 0 7 8 2
2 4 0 4 0 7 8 8 2
2 0 0 0 0 0 7 8 2
2 0 0 0 0 0 0 7 2
2 0 0 0 0 0 0 0 2
2 0 0 0 0 0 0 0 2
2 0 0 0 0 0 0 0 2
2 0 0 4 7 4 0 0 2
2 0 0 7 8 7 0 0 2
2 0 7 8 8 8 7 0 2
2 0 4 7 8 7 4 0 2
2 0 0 0 7 0 0 0 2
2 0 0 0 0 0 0 0 2
2 0 0 0 0 0 0 0 2
2 0 0 4 0 4 0 0 2
2 0 0 0 0 0 0 0 2
2 0 0 0 0 0 0 0 2
2 0 7 0 0 0 7 0 2
2 7 8 7 4 7 8 7 2
2 0 7 0 0 0 7 0 2
2 0 0 0 7 0 0 0 2
2 0 0 0 0 0 0 0 2
2 0 7 0 0 0 7 0 2
2 0 0 0 0 0 0 0 2
2 0 0 0 8 0 0 0 2
2 0 0 8 7 8 0 0 2
2 0 0 0 8 0 0 0 2
2 0 0 0 0 0 0 0 2
2 0 0 0 0 0 0 0 2
2 0 8 0 0 0 8 0 2
2 8 7 8 0 8 7 8 2
2 0 8 0 0 0 8 0 2
2 0 0 0 0 0 0 0 2
2 0 0 0 0 0 0 0 2
2 0 0 0 3 0 0 0 2
2 0 0 0 0 0 0 0 2
2 0 0 0 0 0 0 0 2
2 0 0 0 0 0 0 0 2
2 0 0 0 0 0 0 0 2
2 2 2 2 2 2 2 2 2
