9 100
255 1750 0
2 2 2 2 5 2 2 2 2
2 0 0 0 6 0 0 0 2
2 0 0 0 0 0 0 0 2
2 0 0 0 0 0 0 0 2
2 0 0 0 0 0 0 0 2
2 0 0 0 0 0 0 0 2
2 0 0 0 0 0 0 0 2
2 0 0 0 0 0 0 0 2
2 0 0 0 0 0 0 0 2
2 0 0 0 0 0 0 0 2
2 9 9 9 9 9 9 9 2
2 0 0 0 0 0 0 0 2
2 0 0 0 0 0 0 0 2
2 4 4 0 0 0 4 4 2
2 0 0 0 0 0 0 0 2
2 0 0 0 0 0 0 0 2
2 0 0 0 0 0 0 0 2
2 0 0 0 0 0 0 0 2
2 0 0 0 0 0 0 0 2
2 0 0 4 0 4 0 0 2
2 0 7 0 7 0 7 0 2
2 7 0 0 0 0 0 7 2
2 0 7 0 7 0 7 0 2
2 7 0 0 0 0 0 7 2
2 0 7 0 7 4 7 0 2
2 7 0 0 0 0 0 7 2
2 0 7 4 7 0 7 0 2
2 7 0 0 0 0 0 7 2
2 0 7 0 7 0 7 0 2
2 0 0 0 0 0 0 0 2
2 0 4 0 0 7 7 7 2
2 7 0 0 0 7 8 7 2
2 0 0 0 0 7 7 7 2
2 0 0 0 0 0 0 0 2
2 0 0 0 0 0 0 0 2
2 0 4 0 0 4 4 0 2
2 0 0 0 0 0 0 0 2
2 0 0 0 0 0 0 0 2
2 7 7 7 0 0 0 0 2
2 7 8 7 0 0 0 7 2
2 7 7 7 0 0 0 0 2
2 4 0 0 0 0 0 4 2
2 0 0 0 0 0 0 0 2
2 0 0 7 7 0 7 7 2
2 0 0 0 4 0 0 0 2
2 0 0 0 0 0 0 0 2
2 7 7 0 7 7 0 0 2
2 4 0 0 4 0 0 4 2
2 0 0 0 0 0 0 0 2
2 0 0 7 7 0 7 7 2
2 0 0 0 0 0 0 0 2
2 0 0 0 0 0 0 0 2
2 0 0 4 4 4 0 0 2
2 0 0 0 0 0 0 0 2
2 0 0 0 0 0 0 0 2
2 0 4 0 0 0 4 0 2
2 0 0 0 0 0 0 0 2
2 7 7 0 0 0 0 0 2
2 7 7 0 0 0 7 0 2
2 0 0 0 0 0 0 0 2
2 0 4 0 4 0 4 0 2
2 0 0 0 0 0 7 7 2
2 0 7 0 0 0 7 7 2
2 0 0 0 0 0 0 0 2
2 0 0 0 0 0 0 0 2
2 0 0 0 0 0 0 0 2
2 0 0 4 0 0 4 0 2
2 0 0 0 0 0 0 0 2
2 0 7 0 0 0 4 0 2
2 0 0 0 0 0 0 0 2
2 0 0 0 4 0 0 0 2
2 0 0 0 0 0 0 0 2
2 0 4 0 0 0 4 0 2
2 0 0 0 0 0 7 0 2
2 0 0 0 0 0 0 0 2
2 0 4 0 4 0 4 0 2
2 0 0 0 0 0 0 0 2
2 0 0 0 0 0 0 0 2
2 0 0 0 0 0 0 0 2
2 7 0 0 0 0 0 7 2
2 0 7 0 0 0 7 0 2
2 0 0 0 7 0 0 0 2
2 0 0 7 7 7 0 0 2
2 0 0 0 7 0 0 0 2
2 7 7 0 7 0 7 7 2
2 0 0 0 0 0 0 0 2
2 0 0 0 0 0 0 0 2
2 0 0 7 7 7 0 0 2
2 0 0 0 0 0 0 0 2
2 0 0 0 0 0 0 0 2
2 7 7 7 0 7 7 7 2
2 0 0 0 0 0 0 0 2
2 0 0 0 0 0 0 0 2
2 0 0 0 0 0 0 0 2
2 0 0 0 0 0 0 0 2
2 0 0 0 3 0 0 0 2
2 0 0 0 0 0 0 0 2
2 0 0 0 0 0 0 0 2
2 0 0 0 0 0 0 0 2
2 0 0 0 0 0 0 0 2
2 2 2 2 2 2 2 2 2
