9 100
255 1750 1
2 2 2 2 5 2 2 2 2
2 0 0 0 6 0 0 0 2
2 0 0 0 0 0 0 0 2
2 0 0 0 0 0 0 0 2
2 0 0 0 0 0 0 0 2
2 0 0 0 0 0 0 0 2
2 0 0 0 0 0 0 0 2
2 0 0 0 0 0 0 0 2
2 0 0 0 0 0 0 0 2
2 0 0 0 0 0 0 0 2
2 9 9 9 9 9 9 9 2
2 0 0 0 0 0 0 0 2
2 4 0 0 4 0 0 4 2
2 0 0 0 0 0 0 0 2
2 0 0 0 0 0 0 0 2
2 0 0 0 0 0 0 0 2
2 0 0 0 0 0 0 0 2
2 0 0 0 0 0 0 0 2
2 0 0 0 0 0 0 0 2
2 0 0 0 0 0 0 0 2
2 0 4 0 0 0 4 0 2
2 0 0 0 4 0 0 0 2
2 0 4 0 0 0 4 0 2
2 0 0 0 0 0 0 0 2
2 0 0 0 0 0 0 0 2
2 0 0 0 0 0 0 0 2
2 0 0 0 0 0 0 0 2
2 0 0 0 0 0 0 0 2
2 0 0 0 0 0 0 0 2
2 0 0 4 4 4 0 0 2
2 0 0 0 0 0 0 0 2
2 0 0 0 0 0 0 0 2
2 0 0 0 0 0 0 0 2
2 0 0 0 0 0 0 0 2
2 0 0 0 0 0 0 0 2
2 0 0 0 0 0 0 0 2
2 0 0 4 0 0 4 4 2
2 0 0 0 0 0 0 0 2
2 0 0 0 0 0 0 0 2
2 0 0 0 0 0 0 0 2
2 0 0 0 0 0 0 0 2
2 0 4 4 0 0 0 0 2
2 0 0 0 0 0 0 0 2
2 0 0 0 0 0 0 0 2
2 0 0 0 0 0 0 0 2
2 0 0 0 0 0 0 0 2
2 0 0 4 0 0 4 0 2
2 0 0 0 0 0 0 0 2
2 0 0 0 0 0 0 0 2
2 0 0 0 0 0 0 0 2
2 0 0 0 0 0 0 0 2
2 0 0 0 0 0 0 0 2
2 0 0 0 0 0 0 0 2
2 0 4 0 4 0 4 0 2
2 0 0 0 0 0 0 0 2
2 0 0 0 0 0 0 0 2
2 0 0 0 0 0 0 0 2
2 0 0 0 0 0 0 0 2
2 0 0 0 0 0 0 0 2
2 4 4 4 0 0 0 0 2
2 0 0 0 0 0 0 0 2
2 0 0 0 0 0 0 0 2
2 0 0 0 0 0 0 0 2
2 0 0 0 4 4 0 0 2
2 0 0 0 0 0 0 0 2
2 0 0 0 0 0 0 0 2
2 0 0 0 0 0 0 0 2
2 0 0 0 4 4 0 0 2
2 0 0 0 0 0 0 0 2
2 0 0 0 0 0 0 0 2
2 0 0 0 0 0 0 0 2
2 0 0 0 0 0 0 0 2
2 0 0 0 0 0 0 4 2
2 0 0 0 0 0 0 0 2
2 4 4 0 0 0 0 0 2
2 0 0 0 0 0 0 0 2
2 0 0 0 0 0 0 0 2
2 0 0 0 0 0 0 0 2
2 0 0 0 0 0 0 0 2
2 0 4 0 0 0 0 4 2
2 0 0 0 0 0 0 0 2
2 0 0 0 0 0 4 0 2
2 0 0 0 0 0 0 0 2
2 0 0 0 0 0 0 0 2
2 0 0 0 0 0 0 0 2
2 0 0 0 0 0 0 0 2
2 0 0 0 0 0 0 0 2
2 0 0 0 0 0 0 0 2
2 0 0 0 0 0 0 0 2
2 0 0 0 0 0 0 0 2
2 0 0 0 0 0 0 0 2
2 0 0 0 0 0 0 0 2
2 0 0 0 0 0 0 0 2
2 0 0 0 0 0 0 0 2
2 0 0 0 0 0 0 0 2
2 0 0 0 3 0 0 0 2
2 0 0 0 0 0 0 0 2
2 0 0 0 0 0 0 0 2
2 0 0 0 0 0 0 0 2
2 0 0 0 0 0 0 0 2
2 2 2 2 2 2 2 2 2
