9 100
255 1750 2
2 2 2 2 5 2 2 2 2
2 0 0 0 6 0 0 0 2
2 0 0 0 0 0 0 0 2
2 0 0 0 0 0 0 0 2
2 0 0 0 0 0 0 0 2
2 0 0 0 0 0 0 0 2
2 0 0 0 0 0 0 0 2
2 0 0 0 0 0 0 0 2
2 0 0 0 0 0 0 0 2
2 0 0 0 0 0 0 0 2
2 9 9 9 9 9 9 9 2
2 8 0 0 0 0 0 8 2
2 8 8 0 0 0 8 8 2
2 8 8 8 4 8 8 8 2
2 8 8 0 0 0 8 8 2
2 8 0 0 0 0 0 8 2
2 0 0 0 0 0 0 0 2
2 0 4 4 0 4 4 0 2
2 0 0 0 0 0 0 0 2
2 0 0 0 0 0 0 0 2
2 0 0 0 0 0 0 0 2
2 8 0 0 0 0 0 8 2
2 8 8 0 0 0 8 8 2
2 8 0 4 4 4 0 8 2
2 0 0 0 0 0 0 0 2
2 0 4 0 0 0 4 0 2
2 0 0 0 0 0 0 0 2
2 0 8 8 0 8 8 0 2
2 0 8 8 0 8 8 0 2
2 0 8 8 0 8 8 0 2
2 0 0 4 4 4 0 0 2
2 8 0 0 0 0 0 8 2
2 8 8 0 0 0 8 8 2
2 8 0 0 0 0 0 8 2
2 0 0 0 4 0 0 0 2
2 0 0 0 0 0 0 0 2
2 0 0 0 0 0 0 0 2
2 0 0 0 0 0 0 0 2
2 0 0 4 4 4 0 0 2
2 0 0 0 0 0 0 0 2
2 0 0 0 0 0 0 8 2
2 8 0 0 0 0 8 8 2
2 8 8 0 0 8 8 8 2
2 8 0 0 0 0 8 8 2
2 0 0 4 4 0 0 8 2
2 0 0 0 0 0 0 0 2
2 0 0 0 0 4 0 0 2
2 0 0 0 0 0 0 0 2
2 8 0 0 0 0 0 0 2
2 8 8 0 0 0 0 8 2
2 8 8 8 4 4 8 8 2
2 8 8 0 0 0 0 8 2
2 8 0 0 0 0 0 0 2
2 4 0 0 0 0 0 4 2
2 0 0 0 0 0 0 8 2
2 8 0 0 0 0 8 8 2
2 8 8 0 0 8 8 8 2
2 8 0 0 0 0 8 8 2
2 0 0 0 0 0 0 8 2
2 0 0 4 0 4 0 0 2
2 0 0 0 0 0 0 0 2
2 0 0 0 0 0 0 0 2
2 0 0 0 0 0 0 0 2
2 4 0 0 0 0 0 4 2
2 0 0 0 8 0 0 0 2
2 0 0 8 8 8 0 0 2
2 0 0 0 8 0 0 0 2
2 0 0 0 0 0 0 0 2
2 0 4 0 0 0 4 0 2
2 0 0 0 0 0 0 0 2
2 8 0 0 0 0 0 8 2
2 8 8 0 0 0 8 8 2
2 8 0 0 0 0 0 8 2
2 0 0 0 0 0 0 0 2
2 0 4 0 0 0 4 0 2
2 0 0 0 0 0 0 0 2
2 0 0 0 0 0 0 0 2
2 0 0 0 0 0 0 0 2
2 0 0 4 0 4 0 0 2
2 0 0 0 0 0 0 0 2
2 0 0 0 0 0 0 0 2
2 0 0 0 0 0 0 0 2
2 0 0 0 0 0 0 0 2
2 0 0 0 0 0 0 0 2
2 0 0 0 0 0 0 0 2
2 8 0 0 0 0 0 8 2
2 8 8 0 0 0 8 8 2
2 8 8 8 0 8 8 8 2
2 8 8 8 8 8 8 8 2
2 8 8 8 0 8 8 8 2
2 8 8 0 0 0 8 8 2
2 8 0 0 0 0 0 8 2
2 0 0 0 0 0 0 0 2
2 0 0 0 0 0 0 0 2
2 0 0 0 0 0 0 0 2
2 0 0 0 3 0 0 0 2
2 0 0 0 0 0 0 0 2
2 0 0 0 0 0 0 0 2
2 0 0 0 0 0 0 0 2
2 0 0 0 0 0 0 0 2
2 2 2 2 2 2 2 2 2
